{
  "level": [
    ["S", "S", "S", "S", "S", "S", "S", "S", "S", "S", "S", "S", "S", "S", "S"],
    ["S", ".", ".", ".", ".", ".", ".", ".", ".", ".", ".", ".", ".", ".", "S"],
    ["S", ".", ".", ".", ".", ".", ".", ".", ".", ".", ".", ".", ".", ".", "S"],
    ["S", ".", ".", ".", ".", ".", ".", ".", ".", ".", ".", ".", ".", ".", "S"],
    ["S", ".", ".", ".", ".", ".", ".", ".", ".", ".", "G", "G", "G", "C", "S"],
    ["S", ".", ".", ".", ".", ".", ".", ".", ".", "G", "D", "D", "S", ".", "S"],
    ["S", ".", ".", ".", ".", ".", ".", ".", "G", "D", "D", "S", ".", ".", "S"],
    ["S", ".", ".", ".", "G", "G", ".", ".", "D", "S", "S", "C", "C", "C", "S"],
    ["S", "P", ".", "G", "D", "D", "G", ".", "S", "S", "S", "F", "C", "C", "S"],
    ["S", "R", "R", "R", "R", "R", "R", "R", "R", "R", "R", "R", "R", "R", "S"]
  ]
}
