{
    "level": [
    ["G", "G", "G", "G", "G", "G", "G", "G", "G", "G", "G", "G", "G", "G", "G", "G", "G", "G", "G", "G", "G", "G", "G", "G", "G", "G", "G", "G", "G", "G", "G", "G", "G", "G", "G"],
    ["G", ".", ".", ".", ".", ".", ".", ".", ".", ".", ".", ".", ".", ".", ".", ".", ".", ".", ".", ".", ".", ".", ".", ".", ".", ".", ".", ".", ".", ".", ".", ".", ".", ".", "G"],
    ["G", ".", ".", ".", ".", ".", ".", ".", ".", ".", ".", ".", ".", ".", ".", ".", ".", ".", ".", ".", ".", ".", ".", ".", ".", ".", ".", ".", ".", ".", ".", ".", ".", ".", "G"],
    ["G", ".", ".", ".", ".", ".", ".", ".", ".", ".", ".", ".", ".", ".", ".", ".", ".", ".", ".", ".", ".", ".", ".", ".", ".", ".", ".", ".", ".", ".", ".", ".", ".", ".", "G"],
    ["G", ".", ".", ".", ".", ".", ".", ".", ".", ".", ".", ".", ".", ".", ".", ".", ".", ".", ".", ".", ".", ".", ".", ".", ".", ".", ".", ".", ".", ".", ".", ".", ".", ".", "G"],
    ["G", ".", ".", ".", ".", ".", ".", ".", ".", ".", ".", ".", ".", ".", ".", ".", ".", ".", ".", ".", ".", ".", ".", ".", ".", ".", ".", ".", ".", ".", ".", ".", ".", ".", "G"],
    ["G", ".", ".", ".", ".", ".", ".", ".", ".", ".", ".", ".", ".", ".", ".", ".", ".", ".", ".", ".", ".", ".", ".", ".", ".", ".", ".", ".", ".", ".", ".", ".", ".", ".", "G"],
    ["G", ".", ".", ".", ".", ".", ".", ".", ".", ".", ".", ".", ".", ".", ".", ".", ".", ".", ".", ".", ".", ".", ".", ".", ".", ".", ".", ".", ".", ".", ".", ".", ".", ".", "G"],
    ["G", ".", ".", ".", ".", ".", ".", ".", "S", "S", "S", "S", "S", "S", "S", "S", "S", ".", ".", ".", ".", ".", ".", ".", ".", ".", ".", ".", ".", ".", ".", ".", ".", ".", "G"],
    ["G", ".", ".", ".", ".", ".", ".", ".", "S", "S", "S", "S", "S", "S", "S", "S", "S", ".", ".", ".", ".", ".", ".", ".", ".", ".", ".", ".", ".", ".", ".", ".", ".", ".", "G"],
    ["G", ".", ".", ".", ".", ".", ".", ".", ".", "S", "S", "S", "S", "S", "S", "S", "S", ".", ".", ".", ".", ".", ".", ".", ".", ".", ".", ".", ".", ".", ".", ".", ".", ".", "G"],
    ["G", ".", ".", ".", ".", ".", ".", ".", ".", ".", ".", "S", "S", "S", "S", "S", "S", ".", ".", ".", ".", ".", ".", ".", ".", ".", ".", ".", ".", ".", ".", ".", ".", ".", "G"],
    ["G", ".", ".", ".", ".", ".", ".", ".", ".", ".", ".", ".", "S", "S", "S", "S", "S", ".", ".", ".", ".", ".", ".", ".", ".", ".", ".", ".", ".", ".", ".", ".", ".", ".", "G"],
    ["G", ".", ".", ".", ".", "C", ".", ".", ".", ".", ".", ".", ".", "S", "S", "S", "S", ".", ".", ".", ".", ".", ".", ".", ".", ".", ".", ".", ".", ".", ".", ".", ".", ".", "G"],
    ["G", ".", ".", ".", "G", "G", "G", ".", ".", ".", ".", ".", ".", ".", ".", ".", "S", ".", ".", ".", ".", ".", ".", ".", ".", ".", ".", ".", ".", ".", ".", ".", ".", ".", "G"],
    ["G", ".", ".", ".", ".", ".", ".", ".", ".", ".", ".", ".", ".", ".", ".", ".", ".", ".", ".", ".", ".", ".", ".", ".", ".", ".", ".", ".", ".", ".", ".", ".", ".", ".", "G"],
    ["G", ".", ".", ".", ".", ".", ".", ".", ".", "G", "G", ".", ".", ".", ".", ".", ".", ".", ".", ".", ".", ".", ".", ".", ".", ".", ".", ".", ".", ".", ".", ".", ".", ".", "G"],
    ["G", ".", ".", ".", ".", ".", ".", "G", "G", "D", "D", "G", ".", ".", ".", ".", ".", ".", ".", ".", ".", ".", ".", ".", ".", ".", ".", ".", ".", ".", ".", ".", ".", ".", "G"],
    ["G", ".", ".", ".", "P", ".", "G", "D", "D", "D", "D", "D", "G", "G", ".", ".", ".", ".", ".", ".", ".", ".", ".", ".", "E", ".", ".", ".", ".", ".", ".", ".", ".", ".", "G"],
    ["S", "S", "S", "S", "S", "S", "S", "S", "S", "S", "S", "S", "S", "S", "S", "S", "S", "S", "S", "S", "S", "S", "S", "S", "S", "S", "S", "S", "S", "S", "S", "S", "S", "S", "S"]
  ],
  "tiles": {
    "G": "grass",
    "S": "stone",
    ".": "empty",
    "P": "player",
    "C": "collectable",
    "E": "enemy",
    "D": "dirt"
  }
}
