{
    "level": [
    ["G", "G", "G", "G", "G", "G", "G", "G", "G", "G", "G", "G", "G", "G", "G", "G", "G", "G", "G", "G", "G", "G", "G", "G", "G", "G", "G", "G", "G", "G", "G", "G", "G", "G", "G"],
    ["G", ".", ".", ".", ".", ".", ".", ".", ".", ".", ".", ".", ".", ".", ".", ".", ".", ".", ".", ".", ".", ".", ".", ".", ".", ".", ".", ".", ".", ".", ".", ".", ".", ".", "G"],
    ["G", ".", ".", ".", ".", ".", ".", ".", ".", ".", ".", ".", ".", ".", ".", ".", ".", ".", ".", ".", ".", ".", ".", ".", ".", ".", ".", ".", ".", ".", ".", ".", ".", ".", "G"],
    ["G", ".", ".", ".", ".", ".", ".", ".", ".", ".", ".", ".", ".", ".", ".", ".", ".", ".", ".", ".", ".", ".", ".", ".", ".", ".", ".", ".", ".", ".", ".", ".", ".", ".", "G"],
    ["G", ".", ".", ".", ".", ".", ".", ".", ".", ".", ".", ".", ".", ".", ".", ".", ".", ".", ".", ".", ".", ".", ".", ".", ".", ".", ".", ".", ".", ".", ".", ".", ".", ".", "G"],
    ["G", ".", ".", ".", ".", ".", ".", ".", ".", ".", ".", ".", ".", ".", ".", ".", ".", ".", ".", ".", ".", ".", ".", ".", ".", ".", ".", ".", ".", ".", ".", ".", ".", ".", "G"],
    ["G", ".", ".", ".", ".", ".", ".", ".", ".", ".", ".", ".", ".", ".", ".", ".", ".", ".", ".", ".", ".", ".", ".", ".", ".", ".", ".", ".", ".", ".", ".", ".", ".", ".", "G"],
    ["G", ".", ".", ".", ".", ".", ".", ".", ".", ".", ".", ".", ".", ".", ".", ".", ".", ".", ".", ".", ".", ".", ".", ".", ".", ".", ".", ".", ".", ".", ".", ".", ".", ".", "G"],
    ["G", ".", ".", ".", ".", ".", ".", ".", "S", "S", "S", "S", "S", "S", "S", "S", "S", ".", ".", ".", ".", ".", ".", ".", ".", ".", ".", ".", ".", ".", ".", ".", ".", ".", "G"],
    ["G", ".", ".", ".", ".", ".", ".", ".", "S", "S", "S", "S", "S", "S", "S", "S", "S", ".", ".", ".", ".", ".", ".", ".", ".", ".", ".", ".", ".", ".", ".", ".", ".", ".", "G"],
    ["G", ".", ".", ".", ".", ".", ".", ".", ".", "S", "S", "S", "S", "S", "S", "S", "S", ".", ".", ".", ".", ".", ".", ".", ".", ".", ".", ".", ".", ".", ".", ".", ".", ".", "G"],
    ["G", ".", ".", ".", ".", ".", ".", ".", ".", ".", ".", "S", "S", "S", "S", "S", "S", ".", ".", ".", ".", ".", ".", ".", ".", ".", ".", ".", ".", ".", ".", ".", ".", ".", "G"],
    ["G", ".", ".", ".", ".", ".", ".", ".", ".", ".", ".", ".", "S", "S", "S", "S", "S", ".", ".", ".", ".", ".", ".", ".", ".", ".", ".", ".", ".", ".", ".", ".", ".", ".", "G"],
    ["G", ".", ".", ".", "B", ".", ".", ".", ".", ".", ".", ".", ".", "S", "S", "S", "S", ".", ".", ".", ".", ".", ".", ".", ".", ".", ".", ".", ".", ".", ".", ".", ".", ".", "G"],
    ["G", ".", ".", "H", "G", "G", "G", ".", ".", ".", ".", ".", ".", ".", ".", ".", "S", ".", ".", ".", ".", ".", ".", ".", ".", ".", ".", ".", ".", ".", ".", ".", ".", ".", "G"],
    ["G", ".", ".", ".", ".", ".", ".", ".", ".", ".", "C", ".", ".", ".", ".", ".", ".", ".", ".", ".", ".", ".", ".", ".", ".", ".", ".", ".", ".", ".", ".", ".", ".", ".", "G"],
    ["G", ".", ".", ".", ".", ".", ".", ".", ".", "G", "G", ".", ".", ".", ".", ".", ".", ".", ".", ".", "E", ".", ".", ".", ".", ".", ".", ".", ".", ".", ".", ".", ".", ".", "G"],
    ["G", ".", ".", ".", ".", ".", ".", "G", "G", "D", "D", "G", ".", "C", ".", ".", ".", ".", "G", "G", "G", "G", "G", ".", ".", ".", ".", ".", ".", ".", ".", ".", ".", ".", "G"],
    ["G", "H", ".", ".", "P", ".", "G", "D", "D", "D", "D", "D", "G", "G", ".", ".", "G", "F", "G", ".", ".", ".", ".", ".", ".", ".", ".", ".", "K", ".", ".", ".", ".", ".", "G"],
    ["S", "S", "S", "S", "S", "S", "S", "S", "S", "S", "S", "S", "S", "S", "S", "S", "S", "S", "S", "S", "S", "S", "S", "S", "S", "S", "S", "S", "S", "S", "S", "S", "S", "S", "S"]
  ],
  "tiles": {
    "G": "grass",
    "S": "stone",
    ".": "empty",
    "P": "player",
    "C": "collectable",
    "B": "bomber",
    "D": "dirt",
    "H": "heart",
    "E": "pig_enemy",
    "K": "king_pig",
    "F": "finish"
  }
}
